442222222222333-
441010101010333-
440101010101333-
441010101010333-
440101010101333-
441010101010333-
440101010101333-
442222222222333